##########
#        #
#  S   # #
#   ###  #
#   ###  #
# ###  E##
##########

